11111111111111111111
110C00000010C0000001
10001100011000110001
11001101110001110001
1P000000000000000001
11011C00011001100001
10011C00011001100001
10001100011000110001
10011000011001000001
10011000010001100001
10001100011010110001
10011000011001100001
10011001110001100001
10001100011110110001
10011000000101100001
10011000011001100001
10001101001000110101
10000010001000000001
10110001E000110000E1
11111111111111111111
