11111111111
10000000001
10100PCE001
10100000001
10100000001
11111111111
