11111111
10C00001
10001101
10011C01
10001101
10000101
100001E1
11111111
