11111111
10C00001
10000001
10000E01
10P00001
10011001
10000001
11111111
