11111111111111111111111111111
100CCCCCCCCCCCCCCCCCCCCCCCC01
10000100000000000000000000001
10000P1E0C0000000000000000001
10000100000000000000000000001
11111111111111111111111111111
