111111111111111111111
1E0000C00000000000001
111111111111111110001
1P0000000000001110001
100011111111111C10001
100C00000000001000001
100011111111001011111
100010C00001100000001
100010010001000000001
100000010000000000001
101111111111111000001
100000000000000000001
100000000000000000001
100001111111110000001
100000000000100000001
100000000100100000001
100000000100100000001
100000000100000000001
100000111111111000001
100000011111111100001
100011111111100000001
100000000000000000001
100000001111111110001
111111111111111111111
