111111111111111111111
1E0000C00000000000001
111111111111111110001
1P0000000000001110001
100011111111111C10001
100C00000000001000001
100011111111001011111
100010C00001101000001
100010010001001000001
100000010000001000001
101111111111101011101
100000000100001000001
100000010001001000001
100001111111111000001
100000000000100000001
100000000100100011001
100000000100100011001
100000000100000000001
100000111110111000001
1000000CCCCC111100001
100011111111100000001
100000000000000000001
1000C0001111111110001
111111111111111111111
